###########################
#............#............#
#.####.#####.#.#####.####.#
#o####.#####.#.#####.####o#
#.####.#####.#.#####.####.#
#.........................#
#.####.##.#######.##.####.#
#.####.##.#######.##.####.#
#......##....#....##......#
######.#####.#.#####.######
#    #.#####.#.#####.#    #
#    #.##.........##.#    #
#    #.##.###-###.##.#    #
######.##.#     #.##.######
..........# M M #..........
######.##.# M M #.##.######
#    #.##.#     #.##.#    #
#    #.##.#######.##.#    #
#    #.##....P....##.#    #
######.##.#######.##.######
#............#............#
#.####.#####.#.#####.####.#
#.####.#####.#.#####.####.#
#o..##...............##..o#
###.##.##.#######.##.##.###
###.##.##.#######.##.##.###
#......##....#....##......#
#.##########.#.##########.#
#.##########.#.##########.#
#.........................#
###########################
