#################  ######
                        #
#      ## ## ## ##      #
            P		.
#      # ###-### #	.
#      # #     # #      #
#        #######        #
################ # ######