###################
#                 #
# ### # ### # ### #
# # # #     # # # #
# ### # # # # ### #
#     # #o# #     #
# ##### # # ##### #
# #             # #
# # ##### ##### # #
#o       P       o#
# ##### ### ##### #
#       # #       #
# ### # ### # ### #
# # # #     # # # #
# ### # ### # ### #
#     # # # #     #
# ##### ### ##### #
#        o        #
###################