#########################
#########################
##                     ##
##                     ##
##  .................  ##
##  .               .  ##
##  . ............. .  ##
##  . .           . .  ##
##  . . ......... . .  ##
##  . . .       . . .  ##
##  . . . ..... . . .  ##
##  . . . .   . . . .  ##
##  . . . .   . . . .  ##
##  . . . .   . . . .  ##
##  . . . ..... . . .  ##
##  . . .       . . .  ##
##  . . ......... . .  ##
##  . .           . .  ##
##  . ............. .  ##
##  .               .  ##
##  .................  ##
##                     ##
##                     ##
#########################
#########################