#########################
#########################
##                     ##
##                     ##
##  ..             ..  ##
##  ...     .     ...  ##
##   ...   ...   ...   ##
##    ...   .   ...    ##
##     ...     ...     ##
##      ...   ...      ##
##       ... ...       ##
##    .   .. ..   .    ##
##   ...  .   .  ...   ##
##    .   .. ..   .    ##
##       ... ...       ##
##      ...   ...      ##
##     ...     ...     ##
##    ...   .   ...    ##
##   ...   ...   ...   ##
##  ...     .     ...  ##
##  ..             ..  ##
##                     ##
##                     ##
#########################
#########################