#########################
#########################
##                     ##
##                     ##
##       .......       ##
##     ....   ....     ##
##   ...   ...   ...   ##
##  ..    .....    ..  ##
##  .   ..     ..   .  ##
##  .  ..       ..  .  ##
##  .   ..     ..   .  ##
##  ..   .......   ..  ##
##   ...   ...   ...   ##
##     ....   ....     ##
##       .......       ##
##                     ##
##                     ##
#########################
#########################