#########################
#########################
##                     ##
##                     ##
##         ...         ##
##        .. ..        ##
##       ... ...       ##
##      .... ....      ##
##     ..... .....     ##
##    ...... ......    ##
##   ......   ......   ##
##  ......     ......  ##
##  .               .  ##
##  ......     ......  ##
##   ......   ......   ##
##    ...... ......    ##
##     ..... .....     ##
##      .... ....      ##
##       ... ...       ##
##        .. ..        ##
##         ...         ##
##                     ##
##                     ##
#########################
#########################